// Posicion inicial x, y (contando desde 0), mapa
5 5
O O O O O O O O O O
O X - - - - - - - O
O O - O O O - - - O
O - - O O O - - - O
O - - O O O - - - O
O O - - - - - - - O
O - - - - - - - - O
O - - O - - O - - O
O - - - - - - - - O
O O O O O O O O O O
