// Posicion inicial x, y (contando desde 0), mapa
3 4
T T T T T T T T T T
T - - - - - - - - T
T - - - O - - - - T
T - - - - - - - - T
T - - - - - - - - T
T - - - - - - - - T
T - - - - - - - - T
T - - - - - - - - T
T - - - - - - - - T
T T T T T T T T T T
