// Posicion inicial x, y (contando desde 0), mapa
8 3
T T T T T T T T T T
T - - - - - - - - T
T - - - - - - - - T
T - - - - - - - - T
T - - - - - - - - T
T - - - - - - - - T
T - - - - - - - - T
T - - O - - - - - T
T - - - - - - - - T
T T T T T T T T T T
